00000000000000000
22222222222222222
22245222222222222
22222223222452222
23222222222222222
52222222222222224
22222222222222222
11111111111111111
00000000000000000
00000000000000000