000000000
222222220
222452220
222222230
222222220
327222220
226222220
111111110
000000000
000000000